echo = yozish:
	echo "salom" > name.txt = name.txt ga "salom" deb yozadi,
	echo "yana" >> name.txt ga "yana" deb tagidan yozadi
ls = fayl ichidagi fayllarni ko'rstad:
	ls -a = hamma yashirin fayllarni ham ko'rsatadi
pwd = joriy fayl joyini aniqlash
cd = faylaga o'tish
cat = faylni ichidagi ma'lumotlarno chiqarib beradi
nano = faylni bor bo'lsa ochadi yo'q bo'lsa yaratadi va ochadi
base64 name.txt = faylni shifrlaydi
base64 name.txt | base64 --decode = shrift asliga qaytaradi
find . -name "*.txt" = ".txt" formatdagi fayllarni topib chiqarib beradi
find . -name "*name*" = "name" nomli fayllarni topib chiqarib beradi
grep "name" *.txt = ".txt" formatdagi fayllar ichidan "name" so'zini topib chiqarib beradi
sudo = root huquqi bilan yozish parol kiritish shart
sudo su = doimiy root huquqi bilan yozish
wget = internetdan fayl yuklab olish
curl = sayt sahifa html kodi
zip name.zip name1.txt = name1.txt faylini name nomi bilan nziplash
mkdir = fayl yaratish
touch = fayl yaratish
rm = fayl o'chirish
mk = mkdir ni qisqartmasi
cp ./faylnomi.txt ./ko'chirilayotganfaylnomi = fayl nusxasini ko'chirish
cp ./faylnomi/ ./ko'chirilayotganfaylnomi = fayl nusxasini ko'chirish
mv ./faylnomi.txt ./ko'chirilayotganfaylnomi = faylin ko'chirish
mv faylnomi ko'chirilayotganfaylnomi = faylin ko'chirish, agar ko'chirilayotganfaylnomi mavjud bo'lmasa nomi shu nomga o'zgaradi
wc = fayl holati, tartibi: linya so'z belgi|bayt
man = to'lliq buyruq qo'shimcha vasifalar|haqida namuna: man cp
ps aux = kompyuter ishlash xolat
kill = ishlayotgan fuksiyani o'chirish